1,1,1,1,1,1,1,1,1,1,1,1,1,1,1,1
1,_,_,_,_,_,_,_,_,_,_,_,_,_,_,1
1,_,_,3,3,3,3,_,_,_,2,2,2,_,_,1
1,_,_,_,_,_,4,_,_,_,_,_,2,_,_,1
1,_,_,_,_,_,4,_,_,_,_,_,2,_,_,1
1,_,_,3,3,3,3,_,_,_,_,_,_,_,_,1
1,_,_,_,_,_,_,_,_,_,_,_,_,_,_,1
1,_,_,4,_,_,_,4,_,_,_,_,_,_,_,1
1,1,1,1,1,1,1,1,1,1,1,1,1,1,1,1