1,1,1,1,1,1,1,1,1,1,1,1,1,1,1,1
1,_,_,_,_,4,4,4,4,4,_,_,_,_,2,1
1,_,4,3,_,_,_,_,_,_,_,4,3,_,_,1
1,_,4,_,_,3,3,3,3,3,_,_,3,_,_,1
1,_,4,_,_,4,_,_,_,_,_,_,3,_,_,1
1,4,4,3,_,4,_,_,_,4,_,_,_,_,_,1
1,_,_,_,_,_,_,4,_,_,_,3,_,_,_,1
1,2,_,_,_,4,4,4,_,_,_,4,_,_,2,1
1,1,1,1,1,1,1,1,1,1,1,1,1,1,1,1